11111
10001
100E1
100C1
10P01
11111