11111
10001
100E1
100C1
100P1
11111