1111111111111
100100C0000C1
10P0011111001
100011E000001
1111111111111